GGGPRGGGGGGGGGGGGGGGGGGGGGGGG
GGOLPRGGGGGGGGGGGGGGGTGGGOTGG
GGOLPRGGGGGGGGGFGGGGGGGTTGGGG
TGGLPRGGGGGGGGGGGGGGOGGGGGGGG
GTSLPRGGGGGGGGGGGGGGFGGGGSGGG
STSLPRGGGOGGSGGGGGOGGGGGTGGGG
GGSLPP2GGGGTGGGGGGGFGGGGGFGGG
OGGLPPRGGSGGGGGGGFGGGGGGGGGGG
GGO1PPRGGGGGGOGGFFGGGGGGGGGGG
GOGGLPRGGGGGGGGGFGFGGGGGGGGGG
GGGGLPRGGGGGGGGGGGGGGGGGGGGGG
GGGGLPRGGJGGGGGGGGFGGGCGGGGGG
GGGGLPPNNNNNNN2GGGFGWGSSSSGGG
GGOGLPPPPPPPPPRGGGFGGGSGGGGGG
GTGT1BBBBBBBPPRGGGFGGGSGGGGGG
TOGGGGGGSGGGLPRGGGGGGGSGGGGGG
GGGGTGOTSGGGLPRGGGGGGVSVGGGGG
GGGGTGTGSSSSLPPNNNNNNNNNNNNN2
GGGTGOGSSGGGLPPPPPPPPPPPPPPPR
GGGGGGGSGGGG1BBBBBBBBBBBBBPPR
GGGGGGOGOGGTGGGGGGGGGGGGGGLPR
GGGGGGGOGOGGTGGGGGGGGGGGGGLPR