GGGPRGGGGGGGGGGGGGGGGGGGGGGGG
GGOLPRGGGGGGGGGGGGGGGTGGGOTGG
GGOLPRGGGGGGGGGFGGGGGGGTTGGGG
TGGLPRGGGGGGGGGGGGGGOGGGGGGGG
GTSLPRGGGGGGGGGGGGGGFGGGGSGGG
STSLPRGGGOGGSGGGGGOGGGGGTGGGG
GGSLPP2GGGGTGGGGGGGFGGGGGFGGG
OGGLPPRGGSGGGGGGGFGGGGGGGGGGG
GGO1PPRGGGGGGOGGFFGGGGGGGGGGG
GOGGLPRGGGGGGGGGFGFGGGGGGGGGG
GGGGLPRGGGGGGGGGGGGGGGGGGGGGG
GGGGLPRGGJGGGGGGGGFGGGCGGGGGG
GGGGLPPNNNNNNN2GGGFGWGSSSSGGG
GGGG1BBBBBBBPPRGGGFGGGSGGGGGG
GGGGGGGGGGGGLPRGGGFGGGSGGGGGG
GGGGGGGGGGGGLPRGGGGGGGSGGGGGG
GGGGGGGGGGGGLPRGGGGGGVSVGGGGG
GGGGGGGGGGGGLPPNNNNNNNNNNNNN2
GGGGGGGGGGGGLPPPPPPPPPPPPPPPR
GGGGGGGGGGGG1BBBBBBBBBBBBBPPR
GGGGGGGGGGGGGGGGGGGGGGGGGGLPR
GGGGGGGGGGGGGGGGGGGGGGGGGGLPR